"filename", "language", "solidity", "Markdown", "JavaScript", "comment", "blank", "total"
"/home/gas_limit/leveraged-mm/test/Mocks/FlashLoanMock.sol", "solidity", 25, 0, 0, 1, 13, 39
"/home/gas_limit/leveraged-mm/test/README.md", "Markdown", 0, 5, 0, 0, 4, 9
"/home/gas_limit/leveraged-mm/test/strategy/Long_Base_Odos_ZeroLend/Long_Base_Odos_ZeroLend_Test.t.sol", "solidity", 70, 0, 0, 32, 47, 149
"/home/gas_limit/leveraged-mm/test/strategy/Long_Base_Odos_ZeroLend/OdosAdd.js", "JavaScript", 0, 0, 85, 5, 8, 98
"/home/gas_limit/leveraged-mm/test/strategy/Long_Base_Odos_ZeroLend/OdosRemove.js", "JavaScript", 0, 0, 85, 6, 8, 99
"/home/gas_limit/leveraged-mm/test/strategy/Long_Quote_Odos_ZeroLend/OdosAdd.js", "JavaScript", 0, 0, 85, 5, 8, 98
"/home/gas_limit/leveraged-mm/test/strategy/Long_Quote_Odos_ZeroLend/OdosClose.js", "JavaScript", 0, 0, 85, 5, 8, 98
"/home/gas_limit/leveraged-mm/test/strategy/Long_Quote_Odos_ZeroLend/OdosRemove.js", "JavaScript", 0, 0, 85, 5, 8, 98
"/home/gas_limit/leveraged-mm/test/strategy/Long_Quote_Odos_ZeroLend/Using_Proxy_Long_Quote_Odos_ZeroLend_Test.t.sol", "solidity", 103, 0, 0, 4, 56, 163
"Total", "-", 198, 5, 425, 63, 160, 851